wwwwwwwwwwwwwwwwwwwwwwwwwwwwwwwwwww
w      E                          w
w     DDDDD                       w
w     D   D                       w
w    ED                           w
w     D   D     J                 w
w     DDDDD                       w
w                                 w
w                                 w
w    E                            w
w                                 w
wwwwwwwwwwwwwwwwwwwwwwwwwwwwwwwwwww
