###################################
#                                 #
#                                 #
#                                 #
#                                 #
#               j                 #
#                                 #
#                                 #
#                                 #
#                                 #
#                                 #
###################################
